14,14,14,14,14,14,14,14,14,421
14,14,14,14,14,14,14,14,421,421
14,14,14,14,14,14,14,14,421,468
14,14,14,14,14,14,14,421,468,468
14,14,14,14,14,14,421,468,468,468
14,14,14,14,14,421,421,468,468,468
14,14,14,421,421,421,468,468,468,468
421,421,421,421,468,468,468,468,468,468
421,468,468,468,468,468,468,468,468,468
421,468,468,468,468,468,468,468,468,468
